1111111111111111111111111111111111
1E0000000000000C00000C00N000000001
101001010010000010100100000N010101
101001001010101000100100000N010101
1P0000000C00C00000000000N00N0000C1
1111111111111111111111111111111111